p = player
c = coin
# = block

####################
#c#   #  c  #     p#
# # # # # # # # ####
# # # c # #  c#    #
# # ##### # ###### #
# #c  # #c# #  c # #
#   #   ### # ## # #
######c##  c   # # #
#   #   # #### #  c#
# # c # # #c# c  # #
# ##### #   # ## # #
#c#c      # #  # # #
#### ## # # ## #   #
#p   #c #c#  c # #c#
####################
